11111
1CP11
100E1
10001
1C1C1
11111
11111
