111111111111111111111111111111
1010P1110011C000011E1C00010001
100110000000000001010101101011
100010011101010000000000000101
100100000010001101100011001111
111000010000001011000110111001
101100000010000011111001000101
100100101000111001000000001111
101010000111001011000011011001
101000101000101111101110101111
111111111111111111111111111111
