111111111111111111111111111111
100001110011C000011EC000010001
100110000000000001000101101011
100000011101010000000000000101
100100000010001101100011001111
111000010000001011000110111001
101100000010000011111001000101
100100101000111001000000001111
111001000111100100001010100101
101000010000101001100001010111
111100100011010000010010000111
1P1000010000001001001011101101
110101110000010010100010010101
100001011111011010000000010101
110000111010000110001000000001
100000001110110001000000110001
100011001001001100111000000011
101011000011001101111000100011
101000101000101111101110101111
111111111111111111111111111111
