11111111111
11111P11111
11111100CC1
101E1001101
11111111111
11111111111
